256	192
0	3	4	4	13	8	3	5 
0	3	4	13	4	2	3	5 
5	9	14	10	11	4	3	5 
5	3	2	4	4	12	9	5 
6	3	4	4	13	4	8	5 
7	3	10	14	11	11	10	5