768 192
0 1 1 1 1 1 0 0 0 1 1 1 1 1 0 0 0 0 0 0 2 3 3 4
5 5 5 5 5 5 1 1 5 5 5 5 5 5 1 1 1 1 1 1 17 6 6 7
5 8 5 5 5 5 5 5 5 8 5 5 5 5 5 5 5 5 8 8 9 10 6 4
8 11 8 8 8 8 8 8 8 11 8 8 8 8 8 8 8 8 11 12 9 4 6 7
13 14 15 13 13 15 13 15 13 14 15 13 13 15 13 15 15 16 14 18 19 20 21 7
22 22 22 22 22 22 22 22 22 22 22 22 22 22 22 22 22 22 22 22 22 22 22 22
